BBBBBBBBBBB...BBBBBBBBBBB
B.......................B
B.......................B
B.......................B
B.......................B
B.......................B
B.......................B
B........................
B........................
B........................
B........................
B.......................B
B.......................B
B.......................B
B.......................B
B.......................B
B.......................B
BBBBBBBBBBB...BBBBBBBBBBB