BBBBBBBBBBB...BBBBBBBBBBB
B.......................B
B.......................B
B.......................B
B.......................B
B.......................B
B.......................B
........................B
........................B
........................B
........................B
B.......................B
B.......................B
B.......................B
B.......................B
B.......................B
B.......................B
BBBBBBBBBBBBBBBBBBBBBBBBB