BBBBBBBBBBBBBBBBBBBBBBBBB
B.......................B
B.......................B
B.......................B
B.......................B
B.......................B
B.......................B
B........................
B........................
B........................
B........................
B.......................B
B.......................B
B.......................B
B.......................B
B.......................B
B.......................B
BBBBBBBBBBBBBBBBBBBBBBBBB