BBBBBBBBBBBBBBBBBBBBBBBBB
B.......................B
B.......................B
B.......................B
B.......................B
B.......................B
B.......................B
........................B
........................B
........................B
........................B
B.......................B
B.......................B
B.......................B
B.......................B
B.......................B
B.......................B
BBBBBBBBBBB...BBBBBBBBBBB