YYYYYYYYYYYYYYYYYYYYYYYYY
Y.......................Y
Y.......................Y
Y.......................Y
Y.......................Y
Y.......................Y
Y.......................Y
Y.......................Y
Y.......................Y
Y.......................Y
Y.......................Y
Y.......................Y
Y.......................Y
Y.......................Y
Y.......................Y
Y.......................Y
Y.......................Y
YYYYYYYYYYY...YYYYYYYYYYY