RBRBRBRBRBR...RBRBRBRBRBR
B.......................B
R.......................R
B.......................B
R.......................R
B.......................B
R.......................R
B.......................B
R.......................R
R.......................R
B.......................B
R.......................R
B.......................B
R.......................R
B.......................B
R.......................R
B.......................B
RBRBRBRBRBR...RBRBRBRBRBR