GGGGGGGGGGGGGGGGGGGGGGGGG
G.......................G
G.......................G
G.......................G
G.......................G
G.......................G
G.......................G
G........................
G........................
G........................
G........................
G.......................G
G.......................G
G.......................G
G.......................G
G.......................G
G.......................G
GGGGGGGGGGGGGGGGGGGGGGGGG