GGGGGGGGGGG...GGGGGGGGGGG
.........................
.........................
.........................
.........................
.........................
.........................
.........................
.........................
.........................
.........................
.........................
.........................
.........................
.........................
.........................
.........................
GGGGGGGGGGGGGGGGGGGGGGGGG