GGGGGGGGGGG...GGGGGGGGGGG
G.......................G
G.......................G
G.......................G
G.......................G
G.......................G
G.......................G
.........................
.........................
.........................
.........................
G.......................G
G.......................G
G.......................G
G.......................G
G.......................G
G.......................G
GGGGGGGGGGGGGGGGGGGGGGGGG