G0GGGGGGGGG...GGGGGGGGGGG
.0.......................
.0.......................
.0.......................
.0.......................
.0.......................
.0.......................
.0.......................
.0.......................
.0.......................
.0.......................
.0.......................
.0.......................
.0.......................
.0.......................
.0.......................
.0.......................
G0GGGGGGGGGGGGGGGGGGGGGGG