GGGGGGGGGGGGGGGGGGGGGGG0G
.......................0.
.......................0.
.......................0.
.......................0.
.......................0.
.......................0.
.......................0.
.......................0.
.......................0.
.......................0.
.......................0.
.......................0.
.......................0.
.......................0.
.......................0.
.......................0.
GGGGGGGGGGG...GGGGGGGGG0G