GGGGGGGGGGGGGGGGGGGGGGGGG
G.......................G
G.......................G
G.......................G
G.......................G
G.......................G
G.......................G
........................G
........................G
........................G
........................G
G.......................G
G.......................G
G.......................G
G.......................G
G.......................G
G.......................G
GGGGGGGGGGG...GGGGGGGGGGG