RRRRRRRRRRR...RRRRRRRRRRR
R.......................R
R.......................R
R.......................R
R.......................R
R.......................R
R.......................R
R.......................R
R.......................R
R.......................R
R.......................R
R.......................R
R...............D.......R
R.......................R
R.......................R
R.......................R
R.......................R
RRRRRRRRRRRRRRRRRRRRRRRRR